##########
#........#
#.######.#
#.#....#.#
#.#.##.#.#
#.#.G#.#.#
#.#..#.#.#
#.####.#.#
#......#.#
##########
