########
#......#
#.##G#.#
#......#
########
